10
10
##########
#++++++++#
#++++++++#
#++O++D++#
#|-+--+-H#
#++-++-++#
#++-++-++#
#++X++X++#
#++++++++#
##########